   R         1920 1080
NO ./path_to_the_north_texture.xpm
SO   ./path_to_the_south_texture.xpm

EA ./path_to_the_east_texture.xpm

C    225   ,         30 , 0
WE ./path_to_the_west_texture.xpm

S ./path_to_the_sprite_texture.xpm
F 220,100,0


        111111111111111111111111
        1000000000100000000000001
        1011000001110000002000001
        1001000000000000000000001
111111110011000001110000000000001
100000000011000001110111111111111
11110111111111011100000010001
11110111111111011101010010001
11000000110101011100000010001
10002000000000001102222000001  
110000000E0000001101010010001
1100000111010101111101111000011
11001111 1110101 101111010001
11111 1111111111 111111111111

